 __    __   __          __    __       _______. __  
|  |  |  | |  |        |  |  |  |     /       ||  | 
|  |__|  | |  |        |  |__|  |    |   (----`|  | 
|   __   | |  |        |   __   |     \   \    |  | 
|  |  |  | |  |  __    |  |  |  | .----)   |   |__| 
|__|  |__| |__| (_ )   |__|  |__| |_______/    (__) 
                 |/           
